AAGGAGACTTCGGCTACCCAGAGAAGTTCAGTGCCCAGCTCTACTGAGAAGAATGCTGTG	1	"#F0A3FF"
AGTATGACCAGCAGCGTACTCTCCAGCCACAGCCCCGGTTCAGGCTCCTCCACCACTCAG	2	"#2BCE48"
GGACAGGATGTCACTCTGGCCCCGGCCACGGAACCAGCTTCAGGTTCAGCTGCCACCTGG	3	"#0075DC"
GGACAGGATGTCACCTCGGTCCCAGTCACCAGGCCAGCCCTGGGCTCCACCACCCCGCCA	4	"#993F00"
GGACAGGATGTCACCTCGGTCCCAGTCACCAGGCCAGCCCTGGGCTCCACCACCCCACCA	4'	darkviolet
GCCCACGATGTCACCTCAGCCCCGGACAACAAGCCAGCCCCGGGCTCCACCGCCCCCCCA	5	"#00998F"
GCCCACGGTGTCACCTCGGCCCCGGACACCAGGCCGGCCCCGGGCTCCACCGCCCCCCCA	X	"#808080"
GCCCACGGTGTCACCTCGGCCCCGGAgAgCAGGCCGGCCCCGGGCTCCACCGCgCCCgCA	A	"#FFCC99"
GCCCACGGTGTCACCTCGGCCCCGGAgAgCAGGCCGGCCCCGGGCTCCACCGCCCCCCCA	B	"#94FFB5"
GCCCACGGTGTCACCTCGGCCCCGGACACCAGGCCGGCCCCGGGCTCCACCGCCCCCCAA	C	"#8F7C00"
GCCCACGGTGTCACCTCGGCCCCGGACACCAGGCCCGCCCCGGGCTCCACCGCCCCCCCA	D	"#9DCC00"
GCCCACGGTGTCACCTCGGCCCCGGACACCAGGCCCGCCCCGGGCTCCACCGCgCCCgCA	E	"#C20088"
GCCCACGGTGTCACCTCGGCCCCGGACACCAGGCCGGCCCCGGGCTCCACCGCCCCCACA	F	"#E0FF66"
GCCCACGGTGTCACCTCGGCCCCGGACACCAGGCCGGCCCCGGGCTCCACCGCgCCCgCA	G	"#19A405"
GCCCACGGTGTCACCTCGGCCCCGGACACCAGGCCGGCCCCGGGCTCCACCGCCgCCCCA	H	"#FFA8BB"
GCCCACGGTGTCACCTCGGCCCCGGACACCAGGCCGGCCCCGGGCTCCACCGCgCCCCCA	I	"#426600"
GCCCACGGTGTCACCTCGGCACCGGAgAgCAGGCCGGCCCCGGGCTCCACCGCgCCCgCA	J	"#c2b280"
GCCCACGGTGTCACCTCGGCCCCGGAgAgCAGGCCGGCCCTGGGCTCCACCGCCCCCCCA	K	"#FFFF80"
GCCCACGGTGTCACCTCGGCCCCGGACACCAGGCCGGCCCCGGGCTCCACCGCaCCCCCA	V	"#5EF1F2"
GCCCACGGTGTCACCTCGGCCCCGGACACCAGGCCGGCCCCGGGCTCCACCGCCCCCCCg	W	"#00998F"
GCCCACGGTGTCACCTCGGCCCCGGACACCAGGCGGGCCCCGGGCTCCACCCCGGCCCCG	6	"#E0FF66"
GCCCACGGTGTCACCTCGGCCCCGGACACCAGGCCGGCCCCGGGCTCCACCCCGGCCCCG	6'	lightblue
GGCTCCACCGCCCCCCCAGCCCACGGTGTCACCTCGGCCCCGGACACCAGGCCGGCCCCG	7	"#990000"
GGCTCCACCGCCCCCCCAGCCCATGGTGTCACCTCGGCCCCGGACAACAGGCCCGCCTTG	8	"#FFE100"
GGCTCCACCGCCCCTCCAGTCCACAATGTCACCTCGGCCTCAGGCTCTGCATCAGGCTCA	9	"#654522"
